! SAERO_ID=25      ::  ::,ADC+,ADC-


DETECTOR=25

ROC=2

SLOT=10
  10,   1,   1,   0  ! sAER01+
  11,   1,   2,   0  ! sAER02+
  12,   1,   3,   0  ! sAER03+
  13,   1,   4,   0  ! sAER04+
  14,   1,   5,   0  ! sAER05+
  15,   1,   6,   0  ! sAER06+

SLOT=11
   0,   1,   7,   0  ! sAER07+
   1,   1,   1,   1  ! sAER01-
   2,   1,   2,   1  ! sAER02-
   3,   1,   3,   1  ! sAER03-
   4,   1,   4,   1  ! sAER04-
   5,   1,   5,   1  ! sAER05-
   6,   1,   6,   1  ! sAER06-
   7,   1,   7,   1  ! sAER07-
