! PAERO_ID=25      ::  ::,ADC+,ADC-


DETECTOR=25

ROC=2

SLOT=10
  10,   1,   1,   0  ! pAER01+
  11,   1,   2,   0  ! pAER02+
  12,   1,   3,   0  ! pAER03+
  13,   1,   4,   0  ! pAER04+
  14,   1,   5,   0  ! pAER05+
  15,   1,   6,   0  ! pAER06+

SLOT=13
   0,   1,   7,   0  ! pAER07+
   1,   1,   1,   1  ! pAER01-
   2,   1,   2,   1  ! pAER02-
   3,   1,   3,   1  ! pAER03-
   4,   1,   4,   1  ! pAER04-
   5,   1,   5,   1  ! pAER05-
   6,   1,   6,   1  ! pAER06-
   7,   1,   7,   1  ! pAER07-
